NO textures/colorstone.xpm
SO textures/colorstone.xpm
WE textures/colorstone.xpm
EA textures/colorstone.xpm

F 164,169,20
C 153,204,255

111111111111111111111
10000000000000000001
111111111011111110001
100000000000010000001
110000000000000000001
100000101000111000001
1N1000001000000000001
111111111111111111111
