NO textures/colorstone.xpm
SO textures/colorstone.xpm
WE textures/colorstone.xpm
EA textures/colorstone.xpm

F 164,169,20
C 153,204,255

111111111111111111111
100000000000000000001
111111111012211110001
100000000020010000001
110000000010020000001
100000101012111000001
1N1000001000000000001
111111111111111111111
